200 10
                                                        b               c                  b                      e                                     d                       f
                                                               7                                                                                         7                               |
                                                 P---------P---------P---------         P---------          P---------                        P---------P---------P---------P---------                  |
                                                             a                   d                                                  f                                                                                           |
                                                                                        7                               7                                                7                             |
                                        P---------     P---------           P---------P---------          P---------P---------P---------                               P---------                       |
                                              a                         c                a               d           f                     f     e               f            f                     |
                                7                                                                                                            7                                                          |
P---------P---------P---------P---------P---------P---------P---------P---------P---------P---------P---------P---------P---------P---------P---------P---------P---------P---------P---------P---------|
--------------------------------------------------------------------------------------------------------------------------------------------------------------------------------------------------------|
                                      f                                                                                                                                                                                                                                                                                                                                                            |
                             7
                      P---------P---------
                       f                       e
                                           7
  P---------P---------P---------P---------P---------
             f                    e                     f      f      f      f      f      f      f
               7
P---------P---------P---------P---------P---------P---------P---------P---------P---------P---------P---------P---------P---------P---------P---------P---------P---------P---------P---------P---------|
--------------------------------------------------------------------------------------------------------------------------------------------------------------------------------------------------------|
                                                                                                                                                                                                        |
                                                                                                                                                                                                        |
                                                                              4 4                                                                           4 4                                         |
                              3 3 3                3 3 3                3 3 3      3 3                                   3 3 3                       3 3 3      3 3                                     |
                                                                                                                                                                                                        |
              2 2 2       2 2        2 2       2 2       2 2        2 2                2 2 2           2 2 2         2 2       2 2               2 2                 2 2 2           2 2                |
                                                                                                                                                                                                        |
1 1 1 1 1 1 1       1 1 1                1 1 1               1 1 1                            1 1 1 1         1 1 1                  1 1 1 1 1 1                            1 1 1 1       1 1 1 1 1 1 1 |
O---------O---------O---------O---------O---------O---------O---------O---------O---------P-P-P-P-P-O---------P-P-O---------P-P-O---------P-P-O---------P-P-O---------O---------O---------O---------P-P-|
--------------------------------------------------------------------------------------------------------------------------------------------------------------------------------------------------------|
                                                                                                                                                                                                        |
                                                                                                                                                                                                        |
                                                                                                                                                                                                        |
                                                                                                                                                                                                        |
                                                                                                                                                                                                        |
                               22                                     3 3                                                                                                                               |
            1 1 1 1 1         2  2     2 2         2 2     2       2 2                                                                                                                                  |
    11111111 1 1 1 1 111111111    11111            1 1 1 1           1 1 1                                                                                                                              |
O---------O---------O---------O---------O---------O---------O---------O---------O---------P-P-P-P-P-O---------P-P-O---------P-P-O---------P-P-O---------P-P-O---------O---------O---------O---------P-P-|
--------------------------------------------------------------------------------------------------------------------------------------------------------------------------------------------------------|
                                                                                                                                                                                                        |
                                                                                                                                                                                                        |
                                                                                                                                                                                                        |
                                                                                                                                                                                                        |
                                                                          4 4                                                                                                                           |
                                3 3 3                 3 3             3 3                                                                                                                               |
                  2 2 2       2       2 2         2 2     2       2 2                                                                                                                                   |
    1 1 1 1 1 1 1       1 1 1             1 1 1 1           1 1 1                                                                                                                                       |
O---------O---------O---------O---------O---------O---------O---------O---------O---------P-P-P-P-P-O---------P-P-O---------P-P-O---------P-P-O---------P-P-O---------O---------O---------O---------P-P-|
--------------------------------------------------------------------------------------------------------------------------------------------------------------------------------------------------------|
                                                                                                                                                                                                        |
                                                         1 1                                                                                                                                            |
      x                                                1     1                                                                                                 1 1 1 1 1 1 1 1 1                        |
                                         Q--Q--Q--Q--1         1               333                                                              1 1 1 1 1 1 1 1                   1 1 1 1 1             |
 O---------         22222              2 2 2 2 2 2 2             2 2 2 2 2 2 232 23                                              2 2 2 2 2 2 2                                             2 2 2 2 2    |
                1111     1 1 1 1 1 1 1       Q--Q--Q--Q--                    3     3 1 1 1 1                       1 1 1 1 1 1 1                                                                        |
                  O---------             1 1 1 1 1 1 1 1 1 1 1 1 1 1 1      3       3        4 4 4 4 4 4 4 4 4 4 4                                                                                      |
   1 2 3 4 1 2 3 4 1 1 1 1 1 1 1 1 1 1 1                 ---             1 1         311                                                                                                                |
O---------O---------O---------O---------O---------O---------O---------O---------O---------P-P-P-P-P-O---------P-P-O---------P-P-O---------P-P-O---------P-P-O---------O---------O---------O---------P-P-|
--------------------------------------------------------------------------------------------------------------------------------------------------------------------------------------------------------|
                                                                                                                                                                                                        |
                                                         1 1                                                                                                                                            |
                                                       1     1                                                                                                 4 4 4 4 4 4 4 4 4                        |
                                                     1         1                                                                               1 1 1 1 1 1 1 1                   1 1 1 1 1              |
                    33333              2 2 2 3 3 3 3             3 3 3 3 3 3 3 3 3                                               3 3 3 3 3 3 3                                             3 3 3 3 3    |
                1111     1 1 1 1 1 1 1                    -                        1 1 1 1 1                       1 1 1 1 1 1 1                                                                        |
                                                         -x-                                 1 1 1 1 1 1 1 1 1 1 1                                                                                      |
                                                         ---                                                                                                                                            |
O---------O---------O---------O---------O---------O---------O---------O---------O---------P-P-P-P-P-O---------P-P-O---------P-P-O---------P-P-O---------P-P-O---------O---------O---------O---------P-P-|
--------------------------------------------------------------------------------------------------------------------------------------------------------------------------------------------------------|
                                                                                                                                                                                                        |
                                                         1 1                                                                                                                                            |
                                                       1     1                                                                                                 1 1 1 1 1 1 1 1 1                        |
                                                     1         1                                                                               1 1 1 1 1 1 1 1                   1 1 1 1 1              |
                    11111              1 1 1 1 1 1 1             1 1 1 1 1 1 1 1 1                                               1 1 1 1 1 1 1                                             1 1 1 1 1    |
                1111     1 1 1 1 1 1 1                    -                        1 1 1 1 1                       1 1 1 1 1 1 1                                                                        |
                                                         -x-                                 1 1 1 1 1 1 1 1 1 1 1                                                                                      |
                                                         ---                                                                                                                                            |
O---------O---------O---------O---------O---------O---------O---------O---------O---------P-P-P-P-P-O---------P-P-O---------P-P-O---------P-P-O---------P-P-O---------O---------O---------O---------P-P-|
--------------------------------------------------------------------------------------------------------------------------------------------------------------------------------------------------------|
